111111111111111111111111111111
1P0000000000000000000000000001
101111111111110000000011100001
100000000000000111110000000001
100000000000000000110000000001
100000000001000000000100000001
101111110001110110111100110001
100000000000000000000111110001
101111110000100000000100000001
101E00010000100000000000000011
101001010000100111111110000011
101000010000100000000000000011
101000010000111111111110010001
100000110000100CC1CC0000000001
100000110000100110000110000011
100000110000100000000000000001
111000000001100000000000000001
111111111111111111111111111011
101010101010111111111111111111
111111111111111111111111111111
