111111111111111111111111111
1P0000000000000000000000001
1011111111111100000CCC11101
100000000000000000110000001
100000000000000000110000001
100000000001000000000100101
1011111100011101100001001E1
100000000000000000000111111
101111110000100000000100001
101CCCC10000100000000000001
101001010000100111111110001
101000010000100000000000001
101000010000100111111110001
100000000000100001000000001
100000110000100110000110001
100000110000100000000000001
100000000001100000000000001
111111111111111111111111111
101010101111111111111111111
111111111111111111111111111
