1111111111111111111
1CC00000000000CCCC1
1C101010011101C11C1
1C1C101000C101CC1C1
1C111C10011101CE1C1
1CCCCC00P00001CC111
1111111111111111111
