11111111111111
11000000000001
11111100000001
11001000001111
11111000000011
11010000000001
11110000000001
1EC000000000P1
11111111111111
10101011111111
11111111111111
