11111111111111
10010000000011
11010111111111
11110000000CC1
1101000C001011
10010000001CC1
11110000001001
1EC000000000P1
11111111111111
10101011111111
11111111111111
