11111111111111
110000000000E1
11111111000001
10000000000001
11000000000001
10000100000001
10000000000001
1E000000CC00P1
11111111111111
10101011111111
11111111111111
