111111111
1CP00E111
101111111
110001111
111111111
