1111111111111111111111111
1EC0P00CCCC000000CCCC00E1
1CC00CCC00CCC00CCC00CCC01
1CC00CCC00CCC00CCC00CCC01
1CC0000CCCC000000CCCC0C01
1CC00CCC00CCC00CCC00CCC01
1CC00CCC00CCC00CCC00CCC01
1CC0000CCCC000000CCCC00C1
1CC00CCC00CCC00CCC00CCC01
1CC00CCC00CCC00CCC00CCC01
1EC0000CC1C000000CCCC00E1
1111111111111111111111111
1010101011111111111111111
1111111111111111111111111
