111111111111111111111111111111
1PCCCCCCCCCCCC00000000000000E1
101111111111110000000011100001
100000000000000000110000000001
100000000000000000110000000001
100000000001000000000100000001
101111110001110110000100110001
100000000000000000000111110001
101111110000100000000100000001
101CCCC00000100000000000000001
101001000000100111111110000001
100000000000100000000000000001
100000000000100111111110010001
100000000000100001000000000001
100000110000100110000110000001
100000110000100000000000000001
100000000000100000000000000001
111111111111111111111111111001
101010101010111111111111111111
111111111111111111111111111111
