11111111111111111111
1PCCCCCE110000001001
10111110111111010101
10000010000000000001
10000000000100000001
11111111111111111111
10101010111111111111
11111111111111111111
