1111111111111111
1000P00100000001
1111111110111111
1EC1100000010001
1111111111111111
