111111111111111111111111
1P0000000100000000000001
1000C00001000000000C0001
100000000100000000000001
100000000000000000000001
111111111111111111111001
100000000000000000000001
100000000C00000000000C01
100000000000100000000001
10C000000000100000000001
10001111111111111100C001
100010000000000000000001
100010000C00000001000001
100010000000000001110111
100010011111111111000001
10C010000000000001000001
1000100000C00000010C0001
100010000000000001000001
10001000000000000E000001
100011111111111101000001
100010000000000001000001
10C010C000C0000001000001
100010000000000001000001
111111111111111111111111
