1111111111111111111111111111111111
1E0000010000100C00100C000000000101
1010010100101000101001000000010101
1010010010101010101001000000010101
1P0001000C00C0001000000000000100C1
1111111111111111111111111111111111
