111111111111111111111111
1P0000000000000000000001
100000000000000000000001
100000000000000000000001
100000000000000000000001
100000000000000000000001
10000000000C000000000001
100000000000000000000001
100000000000000000000001
100000000000000C00000001
111000000000000000000001
10000000C0000C0000000001
100000000000000000000001
100000000000000000C00001
100000000000000000000001
1000000000000C0000000001
100000000000000000000001
100000000000000000000001
100000000000000000000001
100000000000000000011111
100000000000000000010001
100000000000000000000E01
100000000000000000010001
111111111111111111111111
