1111111111111
1E100000000C1
1010101C10101
1010101C10101
1P000000000C1
1111111111111
